7713 8570 7713 5677 6568 5068 6547 8127 7621 6504 4701 5408 4413 4840 5935 4840 4798 5034 5551 5515 5207 5647 5687 3456 5903 3179 4192 3606 3341 5737 4972 3526 4260 3168 3155 4183 4322 4941 4158 3577 3917 4568 3818 4822 4672 4881 4123 4959 4075 3796 
8789 8991 6662 5700 8995 7411 5329 8730 5328 8872 3786 3414 3248 4991 4289 3149 3439 5220 4285 4435 4328 5807 5055 3115 3002 4665 3938 4201 3319 5213 4756 4737 4007 4121 4682 3931 4284 4304 4456 4175 4047 4545 4796 3415 3543 3250 3719 4116 3822 4973 
6922 5735 8954 7555 7292 6174 5328 6786 6181 6378 5881 4192 4538 5688 3380 4036 5320 5554 5282 5159 5500 4042 4823 4410 5173 5158 3623 4735 5133 3477 3900 4117 3205 4828 4697 4954 3591 3275 4179 3366 4219 4566 3744 3218 3908 3529 3569 3458 3206 4898 
6949 6939 8612 8783 6033 6139 5146 5179 5211 6892 3219 3421 4716 4520 4205 5751 4469 5845 3929 3334 4203 5343 5693 3547 5300 5940 3760 5444 3331 3726 3593 3518 3976 4521 3995 3342 3609 3938 3462 3511 4751 3426 4748 4458 4495 4850 4755 3692 4348 4928 
8844 6890 6308 6823 6001 7046 6077 7536 7653 8099 4372 5731 3273 5315 4648 4869 5879 5269 4799 3632 4694 3879 3904 5542 3511 4646 5371 4267 3728 5986 3344 3213 3669 3430 3711 4311 3184 4081 3960 3056 4108 3675 3413 4706 3886 4662 3830 4566 3786 4043 
6558 8156 5649 6575 6645 5028 7752 6278 8148 8357 4487 3856 5169 4873 4078 3999 3434 4032 3940 4169 4494 4547 3239 4473 5463 4879 5170 3729 5623 3650 4779 4529 4859 4967 3554 4521 4782 3188 3221 4632 4555 3439 3481 3996 3497 4374 3315 3678 4530 4061 
7627 6303 5785 5630 5359 5387 5606 8268 5652 7548 3288 3112 3013 5714 4065 5192 5393 4456 4296 5162 4866 3207 5065 3090 3780 3790 3939 4157 4956 3091 4388 3108 3696 4619 4491 3576 4594 3437 3984 3776 4100 3152 3437 4248 3975 3742 4592 3059 3018 4448 
6514 6588 7772 8284 7035 7516 6339 6166 8348 8925 4240 4516 3175 4845 5946 5389 4168 3982 5080 5109 5663 3822 3529 5748 3554 5991 3778 5243 5248 3305 4199 3233 4257 3937 3250 3458 4451 4975 3631 3724 3116 3817 4533 3860 3256 3113 4310 3560 3936 4691 
